border_size=1
usage=map

Wo, Gg, Gs^Fms, Gs^Fms, Gg^Em, Gg, Gg, Gg^Efm, Gs^Fms, Hh^Fds, Hh, Mm, Mm, Ms, Ms, Ms^Xm, Ms^Xm, Ms, Ms, Ms, Mm, Ms, Ms^Xm, Ms^Xm, Mm, Mm, Ms^Xm, Ms^Xm, Mm, Mm, Ms, Ms
Wo, Wo, Wo, Gs^Fms, Wo, Gg^Es, Wwr, Gg, Gg^Em, Gs^Fds, Gs^Fds, Hh^Fds, Hh^Em, Mm, Mm, Ms^Xm, Mm^Xm, Mm^Xm, Wo, Wo, Hh^Es, Mm^Xm, Ms^Xm, Ms^Xm, Ms, Ms^Xm, Ms, Mm^Xm, Aa^Fma, Ms, Aa^Voa, Ms
Wo, Wo, Ww, Wo, Wwf, Wo, Wo, Gg, Gg, Gs^Fms, Gg^Es, Hh^Fds, Hh^Fds, Mm, Mm, Mm, Mm, Mm, Hh^Es, Wo, Wo, Mm, Mm, Mm^Xm, Ms, Ai, Ai, Aa^Voa, Ha^Fma, Aa^Fma, Ms, Ms
Gg, Ww^Ewl, Ww, Ww, Ww, Ww, Ww, Wwf, Wwf, Re, Re, Hh^Em, Gs^Fds, Hh^Fds, Mm, Mm, Hh^Fp, Mm, Mm, Ww, Wo, Hh^Es, Ms^Xm, Ms, Ai, Ai^Es, Aa^Fma, Ms^Xm, Coa^Es, Coa, Coa, Ms
Gg^Es, Ww, Chs, Wwf, Wwf, Ww, Ww, Wwf, Wo, Ww, Re, Gs^Fms, Gg^Em, Mm, Gll^Fp, Hh^Fp, Hh^Fp, Mm, Hh^Fds, Hh^Es, Gs^Fds, Wo, Wog, Ms, Wo, Aa^Fma, Aa^Voa, Ha^Es, Coa, 5 Koa, Coa, Ms
Gg, Gg, Ss, Ss, Ss, Wo, Ww, Ww, Chw, Gg, Gs^Fms, Re, Re, Gs^Fms, Re, Gs^Fms, Gg^Efm, Mm, Gs^Fms, Gs^Fms, Gs^Fms, Wo, Wo, Wwr, Rb, Aa, Aa^Es, Ha^Fma, Ha, Coa, Aa^Voa, Ms
Gg^Efm, Gs^Vht, Gg^Es, Ww^Ewf, Wo, Wo, Wwr, Chw, Ww^Ewl, Chs, Gll^Fp, Gll^Fp, Gg^Es, Re, Gg, Re, Re, Re, Ss^Vhs, Ww, Wo, Wo, Gll^Fdw, Re, Rb^Es, Rb^Es, Rb, Rb, Mm, Ms, Ms, Ms
Gg, Gg, Gg^Em, Ww, Wo, Wo, Wo, Wo, Ss, 2 Khs, Gll^Fp, Gg, Ss, Ss^Vhs, Gll^Fp, Gg, Re, Ss, Ss, Wo, Gll^Fdw, Gll^Fdf, Gll^Fmf, Re, Gll, Re, Gll^Fdw, Mm, Mm, Mm, Mm, Rb
Gg, Ss, Ss^Vhs, Ss, Wo, Wo, Wo, Wwr, Ss^Vhs, Ss, Gg^Em, Gg, Ss, Chs, Ss, Gg^Em, Wwf, Gg^Es, Wo, Wo, Gll^Fp, Gll^Fdf, Gd, Gd, Gd, Gll^Fdf, Gll^Fdw, Hhd^Fdw, Mm, Mm, Mm, Rb
Ww, Gg^Em, Wo, Wo, Wo, Wo, Wo, Ss, Wo, Wo, Wo, Wo, Wo, Ww, Ww, Gg, Wwf, Wo, Ww, Gll^Fmf, Gll^Fmf, Gd^Em, Gd, Gd^Es, Gd, Gll^Fdw, Gll^Fdf, Re^Em, Rd^Es, Mm, Md, Md
Wo, Ww, Wo, Wo, Wo, Wo, Wo, Wo, Gs^Vht, Gs^Fds, Gg^Efm, Ww, Gg, Wo, Wwf, Wwf, Wwf, Wwf, Mm^Xm, Mm^Xm, Hhd^Fmw, Gs, Hhd^Fmf, Gs, Gs, Gs, Gll, Rd, Gll, Rd, Md, Md
Wwr, Wo, Wo, Wo, Ww^Ewl, Gs^Fds, Gs^Fds, Wo, Gs^Fms, Gs^Fds, Gg, Gg, Gg, Wwf, Gll^Fp, Wwf, Hh^Fp, Wwf, Mm, Mm^Xm, Ce, Hh^Fds, Gll^Fmf, Gs^Em, Gg, Gs^Es, Gg, Gll, Md, Md, Md, Md
Wo, Wo, Wo, Wo, Gg, Gs^Fms, Gs^Fds, Ww, Gg, Gg^Em, Gs^Fds, Gs^Fms, Gg, Gg, Gs^Vht, Gll^Fmw, Mm, Mm, Mm^Xm, Mm^Xm, 4 Ket, Rr^Vd, Hh^Fms, Gs^Fds, Gs^Fds, Gg, Gg, Gll^Fmf, Md, Md, Md, Md
Wo, Wo, Wo, Gs^Fds, Gg^Efm, Gg^Em, Gg, Gg, Gg^Em, Gs^Fds, Gg^Efm, Gs^Fds, Gg, Gg, Gll^Fp, Hh^Fp, Hhd^Fdw, Hh^Fp, Mm^Xm, Ce, Mm^Xm, Ce, Mm^Xm, Hh^Fds, Hh^Fms, Gg^Em, Gg, Md, Hh^Fms, Md, Md, Md
Wo, Wo, Wo, Ww, Gs^Fds, Gs^Fms, Gg, Gs^Fds, Gs^Fms, Gg, Gg, Gg, Gs^Fms, Gg, Gg, Gg^Efm, Hh^Fp, Mm^Xm, Mm^Xm, Mm^Xm, Mm, Mm^Xm, Mm, Mm, Hh^Fds, Gs^Fds, Gg, Gll^Fp, Hh^Fp, Hh^Fds, Md, Md
Wo, Wo, Wo, Gs^Fds, Gs^Fds, Gs^Vht, Gg, Gg^Efm, Gs^Fds, Gs^Fds, Gg^Em, Gs^Fds, Gs^Fds, Gg, Gll^Fmw, Gll^Fp, Hh^Fp, Hh^Fp, Hhd^Fdw, Gll^Fp, Gg^Efm, Hh^Fp, Mm^Xm, Mm, Mm, Mm, Gg, Gg^Efm, Hh^Fp, Md, Md, Md
Wo, Wo, Wo, Wwr, Wwf, Ww, Ww, Gs^Fds, Ww, Gs^Fds, Ww, Gg, Gg, Gg, Gg, Gll^Fp, Gg, Gll^Fp, Gll^Fp, Gs^Vht, Hh^Fp, Hh^Fp, Gll^Fp, Mm^Xm, Mm, Mm, Gg, Gll^Fp, Gll^Fp, Md, Hh^Fms, Md
Ww, Wo, Wo, Wo, Wwf, Wwf^Es, Wwf, Wwf, Wwf, Gs^Fds, Wo, Gg, Wo, Gg, Gs^Fds, Gg, Ww^Ewf, Gg, Gg, Gg, Gg, Gll^Fmw, Gg, Hh^Fp, Hh^Fp, Gll^Fmw, Gg, Gg^Em, Gll^Fp, Gll^Fp, Hh^Fds, Hh^Fds
Ds, Ds, Wo, Wwf, Wo, Wwf, Wwf^Es, Wo, Wo, Wo, Wo, Wo, Wo, Wo, Wo, Ww, Wo, Ww, Gs^Fds, Gs^Fds, Gg^Em, Gg, Gg, Gll^Fp, Gll^Fmw, Gll^Fp, Gg^Efm, Gg, Gg, Gll^Fp, Gg, Gg^Em
Ds, Ds^Esd, Ds, Wo, Gs, Wwf, Wo, Wwf, Wwf, Wo, Wo, Wo, Wo, Wo, Wo, Wo, Wo, Wo, Wo, Ww, Gs^Fds, Gs^Fds, Gg^Efm, Gg, Gg^Em, Gg, Gg, Gg, Ww, Gg, Ww^Bw|r, Gg
Gs, Gs, Gs^Es, Ww, Gs, Gs, Gs, Gs, Ww, Wo, Ds, Wwr, Ds, Wo, Wo, Wo, Wo, Wo, Wo, Wo, Wwr, Gs^Fds, Gs^Fds, Gg, Gs^Vht, Gg, Ww, Ww^Bw\r, Gg, Ww, Gg, Ww
Gll^Fp, Gg, Gg, Gs, Gg^Efm, Gs, Gg, Ww, Rd, Ds^Esd, Rd, Ds, Ds, Ww, Ds^Esd, Wo, Wo, Wo, Gs^Efm, Wo, Wo, Wo, Ww, Gg, Gg, Gg, Ww^Ewl, Gg, Chs, Gg, Chs, Gg
Gll^Fp, Gll^Fp, Gg, Gg, Gg, Gg, Gg^Es, Gg, Rd, Rd, Gs, Gs, Dd^Dc, Ds, Ds, Wo, Wo, Wo, Ww, Gs^Fds, Wo, Wo, Wo, Gg, Ww, Ww, Ss^Vhs, Ss, Chs, 3 Khs, Gs^Em, Gs
Hh^Fp, Hh^Fp, Gll^Fp, Gll^Fp, Hh^Fp, Gg, Gg, Gs^Vht, Gg, Gs, Gg, Gs, Rd, Rd, Gs, Gs^Vht, Ww^Ewf, Wo, Wo, Wo, Wo, Wo, Wo, Wo, Wo, Ss, Ss^Em, Ss, Ss, Ss, Ss^Vhs, Gd
Mm, Mm, Hh^Fp, Hh^Fp, Gll^Fp, Gll^Fp, Gg, Gg, Gg^Efm, Gg^Efm, Gg, Gs^Vht, Gs, Gs, Gs, Rd, Ds, Ds, Ds, Wo, Wo, Wo, Wo, Ww, Ww, Ss, Sm, Sm, Sm, Ss, Ss^Em, Ss
Mm, Mm, Mm, Gll^Fp, Gll^Fp, Gg, Gll^Fp, Gg, Gg, Gg^Efm, Gg, Gg^Es, Gg, Gg^Efm, Gs, Rd, Gs, Dd^Esd, Ds, Wo, Wo, Wo, Wo, Ww, Wo, Ww, Ww, Ww, Wo, Ww^Ewf, Ss, Ss
Hh^Fp, Mm, Hh^Fp, Hh^Fp, Gll^Fp, Gll^Fp, Hh^Fp, Hh^Fp, Gg, Gg, Gs^Fds, Gg, Gs^Fds, Gs, Gs^Fds, Gs, Rd, Rd, Ds, Ww, Ds, Wo, Wo, Wo, Wwr, Ww, Wo, Ww^Vm, Wwr, Ww, Ww, Ww
Mm, Hh^Fp, Gll^Fp, Mm, Hh^Fp, Hh^Fp, Gg, Gg^Es, Gg, Gg, Gs^Vht, Gs^Fds, Gs^Fds, Gg, Gg, Gs, Gs, Rd, Gs^Es, Gs, Rd, Ds^Esd, Wo, Wo, Wwr, Wwr, Ww, Wo, Wo, Ww, Ww, Wo
Hh^Fp, Hh^Fp, Gll^Fp, Gll^Fp, Gll^Fp, Gll^Fp, Gs, Gg, Gg, Gs^Fds, Gs, Gs^Fds, Gs^Fds, Gs^Fds, Gg^Efm, Gs, Gs^Fds, Gs, Gs, Gs, Ds, Ds, Ww, Wo, Wo, Wwr, Wo, Wo, Wo, Wo, Ww, Wo
Gll^Fp, Gs, Gs, Gs^Vht, Gd^Es, Gd, Gs, Ce, 1 Ket, Gd, Gd, Gs, Gs^Fds, Gs^Fds, Gs^Fds, Gg, Gg, Gs^Fds, Gs, Dd^Esd, Ds, Ww, Ww, Wo, Wo, Wo, Wog, Wo, Wog, Wo, Wo, Wo
Gd, Gd, Gs^Fms, Gs, Gd, Re, Ce, Ce, Ce, Ce, Ce, Gs, Gs^Fds, Gs^Fds, Gg^Es, Gs, Rd, Gs^Es, Gs^Es, Gs, Ds, Ds^Esd, Wo, Wo, Wo, Wo, Wog, Wog, Wo, Wo, Wog, Wo
Re, Gs^Fms, Gll^Fmf, Gll^Fmf, Re, Re, Rd, Rd, Rd, Rd, Gd, Gg, Gs^Fds, Gs^Fds, Gs^Vht, Gs, Ds, Rd, Ds, Ww, Ww, Wo, Wwr, Wo, Wo, Wog, Wog, Wo, Wog, Wo, Wog, Wog
Rb, Re^Es, Rb, Gll^Fmf, Re, Re, Gll^Fdf, Gs^Fms, Gll^Fmf, Gll^Fmf, Gs, Gs, Gg, Gg, Gs, Gs, Dd^Dc, Ds^Esd, Ds, Ww, Ww, Wo, Wo, Wo, Wog, Wo, Wo, Wog, Wog, Wog, Wog, Wog
Rb, Rb, Gll^Fdf, Rb, Rb^Es, Re, Re, Gll^Fdf, Re, Gll^Fdf, Gd, Gs, Gg^Efm, Gs^Efm, Gs, Rd, Ds^Esd, Ds, Ww, Ww, Wo, Wo, Wog, Wog, Wog, Wo, Wog, Wog, Wog, Wog, Wog, Wog
Rb, Gll^Fmf, Gll^Fdf, Rb, Rb, Gll^Fmf, Gll^Fmf, Re, Rb^Es, Rb, Gd, Gg, Gg, Gs^Efm, Gs, Ds, Rd, Ds, Ds, Wo, Wo, Wo, Wo, Wo, Wo, Wog, Wog, Wog, Wog, Wog, Wog, Wog