border_size=1
usage=map

Wo, Ww^Ewf, Wwf^Es, Gg, Gg, Gs^Fds, Gs^Fms, Gg, Gg, Gs^Fds, Gs^Fds, Gg, Gg, Gg^Es, Gs^Fds, Gs^Fms, Gs^Fms
Gg, Wo, Wo, Gg, Gg, Gs^Fds, Gs^Fds, Gs^Fms, Gs^Fds, Gg, Gg^Efm, Gs^Fds, Gs^Fms, Gg, Gg^Efm, Gs^Fds, Gs^Fds
Gs^Fds, Gg, Gg, Wo, Gg^Efm, Gs^Fds, Gg^Es, Gs^Fds, Gs^Fds, Gg^Em, Gs^Fms, Gs^Fds, Gs^Fds, Gg, Gg, Gs^Fds, Gg
Gs^Fms, Gs^Fds, Gg^Em, Wo, Wo, Gg, Gg, Gg, Gg, Gg, Gs^Fds, Gs^Fds, Gs^Fds, Gg, Gs^Fds, Gg, Gg^Em
Gg, Gs^Fds, Gg, Ww^Ewf, Ww, Gs^Fds, Gs^Fds, Gs^Fms, Gs^Fds, Gg, Gg, Gg^Efm, Gg, Gg^Em, Gs^Fds, Gs^Fds, Gs^Fds
Gg, Gg, Gg^Efm, Gg, Ww, Gs^Fds, Gg^Efm, Gs^Fds, Gs^Fds, Gg, Gs^Fds, Gg, Gg, Gg, Gg, Gg^Efm, Gs^Fds
Gg, Gs^Fds, Gs^Fds, Gg, Gg, Wwf, Ww, Gs^Fds, Gs^Fds, Gs^Fds, Gs^Fds, Gs^Fds, Gs^Fds, Gs^Fds, Gg, Gg, Gg
Gs^Fds, Gs^Fds, Gs^Fds, Gg, Gg^Em, Wwf, Wwf, Gs^Fds, Gg^Efm, Gg, Gg, Gg^Efm, Gg, Gg, Gs^Fds, Gg, Gs^Fms
Gs^Fds, Gs^Fds, Gs^Fds, Gg^Efm, Gs^Fds, Gs^Fds, Gs^Fds, Wwf, Gg, Gg, Gg^Fet, Gg, Gg, Gs^Fds, Gs^Fds, Gs^Fds, Gg
Gs^Fds, Gs^Fms, Gs^Fds, Gs^Fds, Gs^Fds, Gs^Fds, Ww, Wwf, Gg^Fet, Gg, Gg^Ve, Gg, Gg^Fet, Gg^Em, Gg, Gs^Fds, Gg
Gs^Fds, Gs^Fds, Gg^Efm, Gg^Em, Gg, Gg^Efm, Wwf, Wwf, Wwf, Gg, 2 Gg^Efm, Gg, Gg, Gg, Gs^Fds, Gg^Efm, Gg
Gg, Gs^Fds, Gg, Gg, Gs^Fds, Gs^Fds, Gs^Fds, Gg, Gg^Fet, Wwf, Wwf, Gg, Gg^Fet, Gg, Gs^Fds, Gs^Fds, Gs^Fds
Gg, Gg, Gs^Fds, Gg, Gs^Fms, Gs^Fds, Gs^Fds, Gg^Efm, Gg, Wwf, Wwf, Gg, Gg, Gg^Efm, Gs^Fds, Gs^Fds, Gs^Fms
Gs^Fds, Gg^Es, Gs^Fds, Gs^Fds, Gs^Fds, Gs^Fds, Gg^Efm, Gs^Fds, Gg^Em, Gg, Gg, Wwf, Wwf, Gs^Fds, Ww^Ewf, Gs^Fds, Gs^Fds
Gg, Gs^Fds, Gg, Gg, Gs^Fds, Gs^Fds, Gg, Gg, Gg, 1 Gg, Gg^Efm, Gg, Gs^Fds, Wwf, Ww, Gs^Fds, Gg^Em
Gg, Gg, Gs^Fds, Gs^Fds, Gs^Fds, Gg^Em, Gg, Gs^Fds, Gs^Fms, Gg, Gs^Fds, Gg, Gg, Gs^Fds, Wwr, Wo, Gg
Gg, Gs^Fds, Gs^Fds, Gs^Fms, Gg, Gg, Gg, Gs^Fms, Gg, Gs^Fds, Gs^Fds, Gg^Es, Gg, Gg, Gg, Wo, Wo