border_size=1
usage=map

Mm^Xm, Mm^Xm, Mm, Mm, Mm, Mm^Xm, Mm^Xm, Mm^Xm, Mm, Mm, Mm, Mm, Mm, Mm, Mm, Mm^Xm, Mm^Xm, Mm^Xm, Mm, Mm^Xm, Mm^Xm, Mm
Mm^Xm, Mm^Xm, Mm, Mm, Mm, Mm, Hh^Fds, Mm, Hh^Fp, Hhd, Hh^Fp, Mm, Mm, Mm, Hh^Fds, Mm, Hh^Fp, Mm, Hh^Fds, Mm, Mm, Mm
Mm^Xm, Mm, Mm, Mm, Mm, Mm, Hhd^Fmf, Hh^Fds, 4 Kh, Hh^Fds, Hh^Fds, Gll^Fmf, Mm, Mm, Mm, Hh^Fp, Hh^Fds, Gll^Fmf, Hh^Fds, Hh^Fds, Hhd^Fmf, Mm
Mm^Xm, Mm^Xm, Mm, Hh, Mm, Hhd^Vhhr, Hh^Fds, Ch, Chr, Chr, Gll^Fp, Mm, Hh^Fms, Hh^Fms, Hhd^Vhhr, Mm, Mm, Hh^Fds, Hhd, Gs^Fds, Gs^Fms, Hh^Fms
Mm, Mm, Mm, Hh^Fms, Hh^Fms, Hh^Fms, Gd^Em, Gd, Gd, Gd^Em, Mm, Mm, Gll^Fmf, Gll^Fp, Gll^Emf, Hh^Fds, Hh^Fds, Hh^Fms, Ch, Gs^Fds, Gll^Fmf, Gg
Mm, Mm, Mm, Gs, Gg, Gg, Gg, Gg, Gg, Gg^Gvs, Gg, Gg, Gg, Gs^Em, Gg, Hhd^Fmf, Chr, 3 Khr, Chr, Gll^Fmf, Gs^Em, Gg
Gg, Gg, Gg, Mm, Gg, Wwg, Ww^Ewl, Wog, Wog, Gg, Wwg, Wwg, Gg, Gd^Vhr, Gg, Gd, Gd, Gd, Gd, Gd, Gs^Gvs, Gg
Wog, Wog, Wog, Gg, Wwg^Bw|r, Wwg, Gg, Gg, Wog, Wog, Wwg^Bw/r, Gg, Wwg, Ds^Esd, Ds, Gg, Gg, Gs^Gvs, Gs^Gvs, Gs^Gvs, Gd^Vhr, Gg
Wog, Wog, Gs^Fds, Wwg, Gg, Wwg, Gg, Gs, Gg, Gg, Gg, Wwg, Gg, Wog, Wog, Wog, Gg, Gg^Vwm, Gs^Gvs, Gs^Gvs, Gg, Gg
Gs^Fms, Gs^Fds, Gs^Fms, Gg, Gs, Gs, Gs, Gd^Vhr, Gs^Gvs, Gs^Gvs, Gs^Gvs, Gg, Gg, Ds, Wog, Wog, Gg, Gg^Gvs, Gg, Gs^Gvs, Gg, Gg
Gs^Fms, Gs^Fms, Gs^Fds, Gs^Em, Ch, Gs, Chr, Gg, Gg^Gvs, Gs^Gvs, Gg^Gvs, Gg, Ww^Ewf, Wog, Wog, Gg, Gg, Gg, Wwg, Gg, Wog, Wog
Mm, Mm, Mm, Gs^Fms, Rr^Vhc, 2 Khr, Gg, Gg, Gg^Gvs, Gs^Gvs, Gs, Gg, Gg, Gg, Gg, Wwg^Bw/r, Wwg, Wwg, Ds, Wog, Ds^Esd, Wog
Mm, Mm, Mm, Gs^Fds, Gg, Chr, Gg, Gg, Gs^Em, Gs, Gs^Fms, Gg^Vwm, Gs, Gs, Gg^Gvs, Ds^Esd, Ds, Wwg, Wog, Ds, Gs^Es, Ds
Mm, Mm, Gs^Fds, Gs^Fms, Hh^Fp, Gg, Gg^Em, Gll^Fp, Gll^Fp, Gll^Fp, Hh^Fp, Gs^Fms, Gs, Gs^Gvs, Gs^Gvs, Gg^Gvs, Ds, Wog, Wog, Gs^Vh, Gs^Gvs, Gg
Mm^Xm, Md, Md, Hh^Fms, Mm, Hh, Hh^Fds, Gs^Fms, Hhd^Fdf, Md, Md, Md, Md, Gg, Gg, Gs, Wwg^Bw\r, Wwg, Ds^Esd, Ds, Gg, Gg
Mm, Mm^Xm, Mm, Mm, Gs^Fds, Hhd^Fmf, Hhd, Hh, Gs^Fds, Hh^Fp, Gg^Em, Hh^Fms, Hh, Gs^Vh, Gg, Wwg, Ds, Gg, Gg^Efm, Gg, Gg^Efm, Gg
Hh^Fp, Mm, Hh^Fp, Gll^Fmf, Gs^Fds, Gs^Fms, Gs^Fds, Gll^Fmf, Gs^Fds, Gs^Vc, Gg, Gg, Ww^Ewf, Gg^Es, Wo, Wwg, Ds^Esd, Gg^Efm, Gg, Gg^Efm, Gg^Efm, Gg^Efm
Hh^Fp, Hhd^Fmf, Hh^Fp, Gs^Fms, Gs^Fms, Gs^Fms, Gll^Fmf, Gs^Fms, Gg^Em, Gg, Gg, Gg^Efm, Wo, Wo, Wo, Wo, Ds, Gg, Gg, Gs^Vc, Gg, Gg
Gll^Fp, Gll^Fp, Gll^Fp, Gll^Fp, Gll^Fp, Gll^Fp, Gs^Fms, Gs^Fds, Gs^Fds, Gs^Fms, Gg, Gg^Es, Wo, Wo, Ww^Ewl, Ds^Esd, Ce, Ce, Ce, Gg, Gs^Fms, Gs^Fms
Hh^Fp, Hh^Fms, Hh^Fms, Gs^Fms, Gs^Fms, Gg^Ve, Gll^Fmf, Gs^Fms, Gg^Em, Gg, Ds^Esd, Wwg, Wwg, Gg, Gg, Gg^Es, Ce, 1 Ket, Ce, Gg, Gs^Fds, Gs^Fds
Hh^Fp, Hhd^Fdf, Hh^Fp, Hhd^Fmf, Gll^Fp, Gs^Fms, Gll^Fp, Gs^Fds, Gs^Fms, Gg, Ds, Wwg, Gg^Efm, Gg^Efm, Gs^Vc, Gg, Gg, Ce, Gg, Gg^Em, Gs^Fds, Gll^Fp
Hh^Fp, Hh^Fp, Gll^Fp, Gll^Fp, Gll^Fp, Gll^Fp, Gll^Fp, Gs^Fds, Gg, Ds, Ds, Wwg, Wog, Gg^Efm, Gg, Gg, Gg, Gg, Gs^Fds, Gs^Fms, Gll^Fp, Gll^Fp