border_size=1
usage=map

Mm, Mm, Mm^Xm, Mm^Xm, Mm^Xm, Mm^Xm, Mm^Xm, Mm^Xm, Mm^Xm, Mm, Mm, Mm, Mm, Gll^Fp, Hhd^Fmf, Hh, Mm, Mm^Xm, Mm^Xm, Gll^Fp, Gll^Fp, Gll^Fp, Gll^Fp, Gll^Fp, Gll^Fmf, Gll^Fp, Gll^Fmw, Gll^Fp, Gll^Fmw, Gll^Fp, Gll^Fp, Gll^Fp
Hhd^Fdf, Mm, Mm, Mm^Xm, Mm, Mm, Mm, Mm^Xm, Mm, Mm, Hhd^Fdf, Mm, Hhd, Gll^Fp, Gs^Vc, Hhd^Fdf, Hh, Mm^Xm, Mm^Xm, Mm, Mm, Gll^Fp, Gll^Fmw, Gll^Fmw, Gll^Fp, Gll^Fmf, Gll^Fp, Gll^Fmw, Gll^Fmf, Gll^Fmw, Gll^Fmw, Gll^Fp
Hhd^Fdf, Hhd^Fdf, Hhd^Fmf, Mm, Hhd, Mm, Mm, Mm, Mm, Mm, Hh^Fp, Hhd^Fmf, Hhd^Fmf, Gll^Fmf, Mm, Hhd^Fdf, Hhd, Mm, Mm, Ce, 2 Ket, Ce, Gll^Fp, Gll^Fmw, Gll^Fmf, Gll^Fdw, Gs^Vc, Gll^Fmf, Gll^Fmw, Gll^Fp, Gll^Fmw, Gll^Fmw
Gll^Fdf, Gll^Fdf, Hhd^Fmf, Hhd^Fmf, Hhd^Fdf, Hhd, Mm, Mm, Mm, Mm, Hhd, Hhd^Fdf, Gll^Fp, Gll^Fmf, Mm, Mm^Xm, Mm^Xm, Hhd^Fdf, Mm, Mm, Ce, Gll^Fp, Gll^Fp, Gll^Fmw, Gll^Fmw, Gll^Fp, Gll^Fmw, Gll^Fmf, Gll^Fmw, Gll^Fp, Gll^Fmw, Gll^Fmw
Gs, Gll^Fdw, Gll^Fdf, Hh, Hh^Fp, Hhd, Hhd^Fdf, Mm, Hhd^Fdf, Mm, Hhd^Fmf, Gll^Fp, Gll^Fmf, Gll^Fp, Mm, Mm^Xm, Ms^Xm, Mm^Xm, Mm^Xm, Mm^Xm, Mm, Mm, Gll^Fp, Gll^Fmw, Gll^Fp, Gll^Fp, Gll^Fp, Gll^Fp, Gll^Fp, Gll^Fp, Gll^Fp, Gll^Fp
Gs, Gd^Em, Gll^Fdf, Gll^Fdf, Gs^Vc, Hhd^Fmf, Hhd^Fmf, Hh, Hhd^Fmf, Hhd^Fdf, Hhd^Fmf, Hh, Gll^Fp, Gll^Fp, Gll^Fdf, Mm^Xm, Ms, Ms, Ms, Mm^Xm, Mm, Hhd, Mm, Gll^Fdw, Hhd^Fmw, Gll^Fmf, Gll^Fdw, Gll^Fp, Gll^Fdw, Gll^Fp, Gll^Fmf, Gll^Fp
Gs, Gll^Fmf, Gs, Gll^Fmf, Gd^Em, Gll^Fdw, Gll^Fdw, Gll^Fmf, Gll^Fp, Hhd^Fmf, Gll^Fmw, Gll^Fmw, Hhd^Fmf, Mm, Mm, Mm^Xm, Mm^Xm, Ms, Ms, Ms, Ms, Mm^Xm, Mm, Hh^Fp, Hhd^Fmw, Gll^Fp, Gll^Fmw, Gll^Fp, Gd^Em, Gll^Fmf, Gd^Em, Gll^Fmf
Gg^Efm, Gs, Gd, Gd, Gd^Es, Gd, Gg, Gll^Fp, Gg^Efm, Gll^Fmw, Gg^Efm, Gll^Fp, Gll^Fp, Hhd^Fmf, Hhd^Fmw, Hhd, Mm, Ms, Hhd^Fdf, Ms, Ms, Ms, Mm, Hhd, Hh^Fp, Gll^Fmw, Gll^Fmw, Gd, Gs^Es, Gd^Es, Gs, Gd
Gg^Efm, Gs, Ce, Ce, Ce, Gs, Gs, Gll^Fp, Gs, Gg^Efm, Gg^Efm, Gg^Efm, Gll^Fmf, Hhd^Fdw, Hh, Mm, Hhd^Fmf, Mm, Hhd^Fmf, Mm, Hhd, Mm, Hhd^Fmw, Hh^Fp, Gll^Fdw, Gll^Fmw, Gs^Em, Gs, Gs, Gs^Vc, Gs^Es, Gs
Gd, Gd, Ce, 1 Ket, Ce, Gg^Efm, Gs, Gs, Gs^Vc, Gs^Em, Gll^Fp, Gll^Fp, Gll^Fmf, Hhd^Fdf, Hhd^Fdw, Hhd^Fmf, Gll^Fp, Hhd^Fdw, Gll^Fp, Hh^Fp, Hh^Fp, Hh^Fp, Hhd^Fdf, Hh^Fp, Gll^Fmw, Gll^Fp, Gg^Efm, Gg, Gg, Gg^Efm, Ww, Ww
Gg, Gd, Gd, Ce, Gd, Gs, Gd^Es, Gd, Gd^Es, Gg, Gs, Gg^Em, Gll^Fmf, Gll^Fp, Gll^Fp, Gll^Fmf, Gs^Vc, Gs, Gs^Em, Gll^Fmw, Gll^Fmw, Gll^Fp, Gll^Fp, Gll^Fp, Gg^Efm, Gg^Efm, Ww, Ww, Ww, Ww, Ww, Ww
Gd, Gd, Gll^Fdf, Gd^Em, Gll^Fmf, Gs^Vc, Gd, Gs, Gs, Gs, Gs, Gs^Es, Gg, Gll^Fp, Gg, Gg, Gg, Gg, Gg, Gll^Fmw, Gg^Efm, Ww, Ww, Ww, Ww^Bw|r, Gg^Efm, Ww, Ww, Gs, Gg^Efm, Co, Gs
Gd, Gll^Fmf, Gll^Fdf, Gll^Fdf, Gll^Fdf, Gd^Em, Gd, Gs^Es, Gs, Gs^Vc, Gg, Gg, Wwf, Gg, Ww, Gg, Ww, Ww, Ww, Gg^Efm, Ww, Ww, Ww, Ww, Gg, Ww, Ww, Ww, Gg, Co, 4 Ko, Gs
Gd, Gd, Gd^Em, Gll^Fdf, Gll^Fmf, Gll^Fdf, Gs, Gs, Gs^Em, Gg, Gg, Gg, Ww, Wwf, Wwf, Gg^Efm, Ww, Ww, Gg^Efm, Ww, Gg^Efm, Gg^Efm, Gg, Gg^Es, Ss^Vhs, Ww, Ss, Sm, Ss^Vhs, Gg, Gg^Em, Gs
Gd, Gd, Gd, Gll^Fdf, Gs^Vc, Gd^Es, Gd, Gll^Fdf, Gll^Fdf, Gll^Fmf, Gg, Gg, Wwf, Wwf, Wwf, Ww, Wwf, Ww^Ewf, Gg^Efm, Gg^Efm, Gll^Fmf, Gg^Efm, Gg, Sm, Ss, Ss, Gd^Vo, Gg, Gg, Gs, Gll^Fmf, Gll^Fmf
Gll^Fdf, Gd^Em, Gll^Fdf, Gd, Gd, Gd, Gd^Em, Gd, Gll^Fmf, Gll^Fdf, Gg, Ww^Ewf, Ww, Wwf, Wwf, Wwf, Ww, Gg^Em, Gll^Fp, Gll^Fp, Gll^Fp, Gg^Em, Gg, Ss, Gg, Sm, Gg, Gg^Es, Gs, Gs, Gs, Gll^Fmf
Gd, Gll^Fmf, Gll^Fdf, Gd, Gll^Fdf, Gll^Fdf, Gll^Fdf, Gd, Gd^Es, Gll^Fdf, Gg, Ww, Ww, Wwf, Ww, Gg^Efm, Gg, Gg, Gg, Gll^Fmf, Re, Re, Re, Gd^Vo, Re, Gg, Gll^Fdf, Gs, Co, Co, Co, Gd
Gd, Gll^Fdf, Gd^Es, Gd, Gd^Em, Gll^Fmf, Gll^Fdf, Gs^Vc, Gs, Gs, Gs, Gg, Ww, Ww, Ww^Bw/r, Gg^Efm, Gg^Es, Gg, Ss, Gg, Gs, Gll^Fdw, Gll^Fmf, Re^Em, Rb, Gll^Fdw, Gll^Fdf, Gs, Co, 5 Ko, Co, Gd
Gd, Gd, Gd^Em, Gs^Vc, Gd, Gll^Fdf, Gll^Fdf, Gd, Gd^Em, Gs, Gll^Fdf, Gg, Gg, Gg^Efm, Ww, Ww, Ww, Ss^Vhs, Ss, Gg^Es, Gs, Gll^Fdf, Gll^Fdf, Gll^Fmf, Rb, Gll^Fdf, Rd^Es, Gd, Gd, Co, Gd^Es, Gd
Gg, Gll^Fdf, Gll^Fmf, Gll^Fdf, Gll^Fdf, Gd, Gs^Vc, Gd, Gll^Fdf, Gll^Fmf, Gll^Fmf, Gd^Es, Gs, Gg^Efm, Gg^Efm, Ww, Ww, Sm, Ss, Co, Co, Gd, Gd^Vo, Re, Rb, Rb, Re^Em, Gd^Vo, Rb, Gd, Re^Em, Rb
Gll^Fdf, Gll^Fdf, Hhd^Fdf, Gll^Fmf, Gll^Fdf, Gd^Em, Gll^Fdf, Gd, Gll^Fmf, Hhd^Fdf, Gll^Fdf, Gd^Em, Gs, Gg, Ww, Ww, Ss^Vhs, Ss, Co, 3 Ko, Co, Gd, Rd, Re^Em, Gll^Fmf, Gll^Fdf, Gll^Fdw, Rb, Gll^Fdf, Gll^Fmf, Gll^Fdf, Gll^Fdf
Gll^Fdf, Hhd^Fdf, Hhd^Fdf, Gll^Fdf, Gll^Fdf, Gll^Fdf, Gd, Gd, Gll^Fdf, Hhd^Fdf, Hhd^Fdf, Gll^Fmf, Gs, Gg, Ww, Ww, Sm, Ss, Sm, Sm, Sm, Gs, Gd, Gll^Fdf, Hhd^Fdf, Hhd^Fdf, Hhd^Fdf, Re, Re, Re^Em, Gll^Fdf, Hhd^Fdf