border_size=1
usage=map

Gs^Fds, Gg^Em, Gs^Fms, Gs^Fms, Gs^Fds, Gs^Fds, Gg^Em, Gs^Fds, Gs^Fds, Gs^Fds, Ww^Ewf, Ww, Gs^Fds, Gg
Gs^Fds, Gs^Fds, Gs^Fds, Gs^Fds, Gg^Em, Gg, Gs^Fds, Gs^Fds, Gg^Fet, Gs^Fds, Gs^Fds, Gs^Fds, Gs^Fds, Gs^Fds
Gg, Gs^Fds, Gg^Em, Gg, Gg^Efm, Gs^Fds, Gs^Fds, Gs^Fds, Gg^Em, Gg, Gg, Gg^Em, Gg, Gg
Re, Gg, Gs, Gs, Gs, Gg, Gg, Gg, Gs, Gs, Gs, Gg^Efm, Gs, Gg
Gg^Efm, Re, Re, Re, Re, Gs, 1 Re, Re, Re, Re, Re, Gs, Gd^Es, Gs
Gg, Gg, Gg, Gg^Em, Gg^Efm, Re, Gg, Gg, Gg, Gg^Efm, Gg, Re, Re, Gd
Gs^Fds, Gs^Fds, Gs^Fds, Gs^Fds, Gg, Gg^Efm, Gs^Fds, Gs^Fds, Gg, Gs^Fds, Gs^Fds, Gg^Em, Gg, Re
Gs^Fms, Gs^Fds, Gs^Fds, Gs^Fds, Gg, Gg^Em, Gs^Fds, Gs^Fds, Gs^Fds, Gg^Em, Gs^Fds, Gs^Fds, Gs^Fds, Gg^Es
Gg^Em, Gs^Fms, Gs^Fms, Gg^Em, Gs^Fds, Gs^Fds, Gs^Fms, Gs^Fds, Gs^Fds, Gs^Fds, Gs^Fds, Gs^Fds, Gg^Em, Gg
Gs^Fms, Gs^Fms, Gs^Fms, Gs^Fms, Gs^Fds, Gs^Fms, Gs^Fms, Gg^Em, Gg^Em, Gs^Fms, Gs^Fms, Gs^Fds, Gs^Fds, Gs^Fds