border_size=1
usage=map

Gs^Fds, Gs^Fds, Gs^Fds, Gg, Gs, Gd, Re, Rd, Rp, Rd, Re, Wwg, Wwg, Wwg, Wwg, Wog, Wog
Gs, Gll^Fp, Gs^Em, Gs^Vht, Gs, Gd, Re, Rd, Rd, Rr, Co, Wwrg, Co, Wwg, Wwg, Wog, Wog
Gs, Gs, Gs, Gs, Gd, Gd, Gd, Rd, Rd, Rd^Edp, Rr, 2 Ko, Rd, Re, Re, Wwg, Wog
Hh^Fp, Hh^Fp, Hh^Fp, Gs^Fms, Gd, Gd, Dd, Dd^Dc, Gs^Vht, Rd, Ds^Edpp, Co, Ds, Ds^Esd, Ww^Ewf, Wog, Wog
Gs^Fds, Gs^Fms, Gs^Fds, Gll^Fp, Gg, Gd, Gd, Dd, Re, Rd, Rd, Ds, Ww^Ewl, Dd, Wwg, Wwg, Wog
Gs^Fds, Gg^Em, Gg, Gg, Gg, Gs, Gs^Vht, Gs, Gd, Re, Rd, Gg, Gg, Wwg, Wwrg, Wwg, Wog
Ss, Gg, Gs, Gs, Gs^Fms, Gs^Fms, Gg, Gs, Gg, Gd, Gg, Gg, Gg, Ds, Ds, Wwg, Wog
Ss, Ss^Vhs, Ss, Gs, Gg^Es, Gs^Fms, Gg, Gg, Gg^Efm, Gg, Gg, Gs^Vht, Gg, Gg, Dd, Wwg, Wwg
Ww^Ewf, Wwg, Ss, Gd, Gg, Gg, Gg, Gg, Gg^Em, Gg, Wwg, Gg, Ds, Ds^Esd, Ds, Wwg, Wwg
Wwg, Wwg, Wwg, Wwg, Wwg, Gg^Efm, Wwg, Wwg, Wwg, Wwg^Bw\r, Gd, Wwg, Wwg, Wwg, Wwg, Wwg, Wog
Ss, Ss, Ss^Vhs, Ss, Ss, Wwg, Gg, Ww^Ewf, Gg, Gd, Gd, Wwg, Ss, Ss, Ss, Wwg, Wog
Ss, Ss, Gll^Fp, Ss, Gg, Gg, Gd, Gg, Gg, Gg, Gd, Gs, Rr^Vd, Ss, Wwg, Wwg, Wog
Mm, Gll^Fp, Gll^Fp, Gg, Gg, Gd, Gg, Gg, Rr^Vd, Gg, Gg^Em, Gs, Ww^Ewl, Ss, Wwg, Wog, Wog
Mm, Gll^Fp, Hh^Fds, Gg^Em, Hh^Fds, Gg, Gg, Gg, Gll^Fp, Gll^Fp, Gs^Fds, Gs, Mm, Wwg, Wwg, Wog, Wog
Mm, Mm, Mm, Hh^Fds, Mm, Chr, 1 Khr, Chr, Gs^Fds, Hh^Fds, Hh^Fms, Hh^Fp, Md, Mm, Wwrg, Wog, Wog
Mm, Mm, Mm, Mm, Mm, Chr, Chr, Chr, Hh^Fms, Mm, Gs^Vht, Md, Mm^Xm, Mm, Mm, Wwg, Wog
Mm, Mm, Mm, Mm, Mm, Mm, Mm, Gs^Fms, Hh^Fds, Hh^Fp, Hh^Fds, Md, Hh, Mm, Hh, Wwg, Wog