border_size=1
usage=map

Hh^Fms, Rp, Rp, Gd^Fetd, Hh^Fms, Mm, Mm, Mm, Mm, Mm, Mm, Mm, Hh^Fds, Gd^Fetd, Rp, Hh^Fms, Hh^Fms
Hh^Fms, Hh^Fms, Gll^Fp, Rp, Gs^Fds, Hh^Fms, Mm, Mm, Mm, Mm, Mm, Hh^Fp, Gll^Fp, Rp, Mm, Mm, Mm
Mm, Mm, Hh^Fms, Rp^Em, Rp, Gs^Fds, Mm, Mm, Hh^Fp, Mm, Mm, Hh^Fms, Rp, Rp^Em, Mm, Mm, Mm
Mm, Mm, Mm, Gll^Fp, Gd^Fetd, Rp, Gll^Fp, Hh^Fms, Gs^Fds, Hh^Fp, Hh^Fms, Hh^Fms, Rp, Gd^Fetd, Hh^Fds, Hh^Fp, Gll^Fp
Mm, Mm, Mm, Mm, Gll^Fp, Rp, Gs^Fds, Hhd^Vhhr, Gll^Fp, Gs^Fds, Gd^Es, Gll^Fp, Rp, Gs^Fds, Hh^Fds, Gll^Fp, Gd^Em
Mm, Mm, Hh^Fds, Hh^Fds, Gll^Fp, Rp, Rp, Rp, Gd^Fetd, Ce, 3 Ke, Ce, Gs, Gs^Fms, Gs^Fds, Gs^Fms, Gd
Mm, Mm, Mm, Hh^Fds, Gs^Fds, Gll^Fp, Gll^Fp, Rp, Rp, Ce, Gg^Es, Ce, Gs^Fds, Gd^Em, Gd, Gd, Gg
Gll^Fp, Hh^Fms, Hh^Fms, Hh^Vhh, Rp, Gd, Gd, Gd, Rp, Gd, Gs, Gs, Gs, Gd, Gd, Gg^Es, Gll^Fmf
Wo, Gll^Fp, Gg^Em, Gll^Fp, Gg, Rp, Gs^Es, Gs, Rp, Gs, Gs^Fds, Gs^Fds, Gs^Efm, Gs, Gd, Gll^Fmf, Gll^Fmf
Gg, Wo, Wo, Wo, Gs^Fds, Rp, Rp, Rp, Gg^Gvs, Gg^Eff, Gg^Eff, Gs^Fms, Gs, Gs, Gs, Gs, Gg
Gs, Ww^Ewl, Gs^Fds, Wo, Wo, Wo, Rp, Gg^Gvs, Gs^Gvs, Gs^Gvs, Gg^Es, Gg, Ss^Vhs, Gs, Ww^Ewl, Gs, Gg
Gs, Gs^Es, Gg^Efm, Gg^Es, Rr, Wo^Bsb/, Wo, Gs^Vh, Gg^Gvs, Gg^Gvs, Ww^Ewl, Wwr, Ss, Ss, Ww, Gg, Gg
Rp, Rp, Rr^Vhc, Rp, Rr, Gg^Es, Gg, Wwf, Gg^Es, Gs^Fds, Ww, Ww, Ww, Ww^Bw\, Sm^Es, Ww, Ww
Gs^Fds, Gs^Fds, Rp, Rp, Rr, Gs^Fds, Rp, Wwf, Wo, Ww^Ewf, Gg^Gvs, Gg^Gvs, Gg^Gvs, Gg^Gvs, Gg^Gvs, Rb, Gg
Gs^Fds, Gs^Fds, Ch, Ch, Rrc, Rr^Vhc, Rp, Gg^Es, Rp, Wo, Gg^Gvs, Gg^Gvs, Gg^Gvs, Gs^Vh, Rp, Rp, Rp
Gg, Gg^Efm, Gs^Fds, 2 Kh, Ch, Gs^Fds, Rp, Rp, Gs^Fds, Wo^Bsb\, Rp, Gg^Efm, Rp, Rp, Gg^Eff, Gg^Efm, Gg
Rp, Rp, Rp, Ch, Rp, Rp, Rp, Gs^Fds, Ww, Wo, Ww, Rp, Wot, Gg^Eff, Gg, Gg, Gg
Gd, Gd^Es, Gd, Rp, Gd, Rr^Vhc, Rp, Gg, Gs^Vh, Wot, Wo, Gs^Vh, Ww^Ewf, Wot, Ss, Gs^Efm, Gs
Gs^Fms, Gll, Gs^Fms, Gd, Gg^Es, Gs, Gs^Es, Rp, Rp, Wwr, Ww, Wo, Wo, Ww, Wwr, Ss^Vhs, Gs^Fds
Gll^Fp, Gs^Fms, Gd^Fetd, Gs^Fms, Gll, Gd, Gg, Gs, Rp, Gs^Vh, Ww, Wo, Ww^Ewl, Wo, Gs^Fms, Gs^Fms, Hh^Fds
Gll^Fp, Gs^Fds, Gs^Fds, Gll^Em, Gll^Fmf, Gll^Fp, Gg, Gs, Gd, Rp, Gg^Efm, Gg^Vwm, Gg^Efm, Wo, Ss, Gs^Fds, Gs^Fds
Hh^Fms, Gll^Fmf, Hh, Hh^Fms, Hh^Fms, Hh^Fms, Hh^Fms, Gs^Fds, Gg^Es, Rp, Rp, Gg^Efm, Gg, Ww, Ww, Gs^Fms, Gs^Fds
Hh^Fms, Gll^Fp, Hh^Fms, Hh^Fp, Hhd^Fmf, Hhd^Vhhr, Gll^Fp, Gs^Fds, Gs^Fms, Gg, Gg, Rp, Gg^Es, Gg, Ww, Ww^Ewl, Gs^Fds
Md, Hh^Fp, Md, Md, Md, Hh^Fp, Mm, Gll^Fmf, Gd^Fetd, Gll^Em, Gll^Fp, Rp, Rp, Gg, Ss, Ss, Ss
Mm, Md, Mm, Mm, Mm^Xm, Mm, Mm, Gll^Fp, Gll^Fp, Hh^Fms, Ww^Ewl, Wwf, Sm, Ss^Vhs, Wo, Wo, Wo
Mm^Xm, Mm^Xm, Mm^Xm, Mm, Mm^Xm, Mm, Wo, Mm, Wo, Wo, Wo, Wo, Ww, Ww^Bw\r, Rp, Ww^Ewf, Gg
Ms, Ms, Ms, Mm^Xm, Mm^Xm, Mm^Xm, Mm, Wo, Mm, Mm, Hh^Fms, Hh^Fms, Ss^Vhs, Wwf, Gd^Vhr, Rp, Gg
Mm^Xm, Ms, Mm^Xm, Ms, Mm^Xm, Mm, Mm, Mm, Gll^Fp, Mm, Hh^Fms, Gs^Fms, Gs^Fms, Ss, Rp, Rp, Gg^Gvs
Mm^Xm, Mm^Xm, Mm, Mm^Xm, Mm, Mm, Mm, Hhd^Vhhr, Rp, Hh^Fms, Gll^Em, Gs^Fms, Rp, Rp, Chr, Gg^Gvs, Gg^Efm
Mm^Xm, Mm, Mm, Mm, Md, Mm, Hhd^Fmf, Hh^Fms, Gd^Fetd, Rp, Rp, Rp, Rp, Rr^Vhc, 1 Khr, Gs, Gg
Mm, Mm, Md, Md, Gll^Fp, Md, Hh, Gll^Fmf, Gs^Fms, Gll^Em, Gd^Vhr, Gg^Es, Rp, Chr, Gs, Chr, Gs
Mm, Md, Md, Hh^Fms, Hh^Fms, Hh^Fms, Gs^Fms, Gs^Fms, Gg, Gs^Fms, Gg^Gvs, Gs^Gvs, Gs, Rp, Gg, Gg, Gg